1111111011
10000E0001
1C00001101
1000C00001
1111111111
